1111111111111111
10P0000C00E01111
1111111111111111