111111111111111111
10P000C00000000001
1000000000000C0001
10000000C000000001
100000E00000000001
10C0000000C0000001
100000C00000000001
111111111111111111