1111111111111111111111111
1000111000000000000000001
10000C000100000C0001E0001
1011110001000111100000001
1Z0000000C0000000000C0001
1011110000000000100000001
1000001111000000100000001
1000000C01001100100110001
1000001100001100100000001
10P0000001000000000000101
1001111111000000001000101
1000C000000C00000011000C1
1111111111111111111111111