11111111111111
10111000000001
10Z000000E0101
10011111000101
10000000C01101
10100100001001
1P110111000001
11111111111111