1111111111111111111111111
1000000111000000001000001
1000P000000000010101E0001
1000000000000010100000001
1000000P000000000C0000001
1111111111111111111111111